25 21
#####################b###
#...........#....####.###
#...s...s...######......#
#.......................#
#....w......#############
#..w..w.....#
#..w........#...#########
#...........#...#.......#
#####..##########.......#
....#..#.......###......#
....#..#................#
....#..#.......##.......#
..###..######.#.#.......#
..#.......###.#.#########
..#.......###.###
..#..............#
..#..............#
..#.......#######
..#.......#
..#########

