25 21
#####################b###
#...........#....####.###
#...s...s...######......#
#.......................#
#....w......#############
#..w..w.....#   #########
#..w........#...#p.v...p#
#...........#...#v.v###.#
#####..##########al#....#
....#..#.......#####f####
....#..#................#
....#..#.......#####c####
..###..######.#.#.......#
..#.......###.#.#....j..#
..#.......###.###.......#
..#..............#......#
..#..............########
..#.......#######
..#.......#
..#########

